"WWWWWWWWWWWWWWWWWWWWWWWWWWWWWWWWWWWWWWWWWWWWWWWWWWWWWWWWWWWWWWWWWWWWWWWWWWWWWWWWWWWWWWWWWW",
"WWWWWWWWWWWWWW                                        WWWWWWW                           WW",
"WWWWWWWWWWWWWW       T                                WWWWWWW                           WW",
"WWWWWWWWWWWWWW                                        WWWWWWW           T        T      WW",
"WWWWWWWWWWWWWW                                        WWWWWWW                           WW",
"WWWWWWWWWWWWWW                                        WWWWWWW                           WW",
"WWWWWWWWWWWWWW                                        WWWWWWW                           WW",
"WWWWWWWWWWWWWW               WWWWWWWWWW               WWWWWWW                           WW",
"WWWWWWWWWWWWWW               WWWWWWWWWW               WWWWWWW                           WW",
"WWWWWWWWWWWWWW               WWWWWWWWWW               WWWWWWW                           WW",
"WWWWWWWWWWWWWW               WWWWWWWWWW               WWWWWWW                           WW",
"WWWWWWWWWWWWWW               WWWWWWWWWW               WWWWWWW                           WW",
"WWWWWWWWWWWWWW               WWWWWWWWWW               WWWWWWW                           WW",
"WWWW                                                                                    WW",
"WWWW                                                                                    WW",
"WWWW                                                                                    WW",
"WWWW                                                                                    WW",
"WWWW                                                                                    WW",
"WWWW                                                                                    WW",
"WWWW                                                                                    WW",
"WWWW                                                                                    WW",
"WWWW                         WWWWWWWWWW               WWWWWWWWW                         WW",
"WWWW                         WWWWWWWWWW               WWWWWWWWW                         WW",
"WWWW                         WWWWWWWWWW               WWWWWWWWW                         WW",
"WWWW                         WWWWWWWWWW               WWWWWWWWW                         WW",
"WWWW                         WWWWWWWWWW               WWWWWWWWW                         WW",
"WWWW                         WWWWWWWWWW               WWWWWWWWW                         WW",
"WWWW                         WWWWWWWWWW               WWWWWWWWW                         WW",
"WWWW                         WWWWWWWWWW               WWWWWWWWW                         WW",
"WWWW                         WWWWWWWWWW               WWWWWWWWW                         WW",
"WWWW                         WWWWWWWWWW               WWWWWWWWW                         WW",
"WWWW                         WWWWWWWWWW               WWWWWWWWW                         WW",
"WWWW                                                  WWWWWWWWW                         WW",
"WWWW                                                                                    WW",
"WWWW                                                                                    WW",
"WWWW                                                                                    WW",
"WWWW                                                                                    WW",
"WWWW                                                                                    WW",
"WWWW                                                                                    WW",
"WWWW                                                       T                            WW",
"WWWW                                                                                    WW",
"WWWW                                                                                    WW",
"WWWW                                                                                    WW",
"WWWWWWWWWWWWWW                                        WWWWWWWWWWWWWWWWW                 WW",
"WWWWWWWWWWWWWW                 WWWWWWWW               WWWWWWWWWWWWWWWWW                 WW",
"WWWWWWWWWWWWWW                 WWWWWWWW               WWWWWWWWWWWWWWWWW                 WW",
"WWWWWWWWWWWWWW                 WWWWWWWW               WWWWWWWWWWWWWWWWW                 WW",
"WWWWWWWWWWWWWW                 WWWWWWWW               WWWWWWWWWWWWWWWWW                 WW",
"WWWWWWWWWWWWWW       R         WWWWWWWW               WWWWWWWWWWWWWWWWW                 WW",
"WWW                                                   WWWWWWWWWWWWWWWWW                 WW",
"WWW                                                   WWWWWWWWWWWWWWWWW                 WW",
"WWW                                                   WWWWWWWWWWWWWWWWW                 WW",
"WWW                                                   WWWWWWWWWWWWWWWWW                 WW",
"WWW                                                   WWWWWWWWWWWWWWWWW                 WW",
"WWW                                                   WWWWWWWWWWWWWWWWW                 WW",
"WWWWWWWWWWWWWWWWWWWWWWWWWWWWWWWWWWWWWWWWWWWWWWWWWWWWWWWWWWWWWWWWWWWWWWWEEEEEEEEEEEEEEEEEEW",
