"WWWWWWWWWWWWWWWWWWWWWWWWWWWWWWWWWWWWWWWWWWWWWWWWWWWWWWWWWWWWWWWWWWWWWWWWWWWWWWWWWWWWWWWWWW"
"WWWWWWWWWWWWWWWWWWWWWWWWWWWWWWWWWWWWWWWWWWWWWWWWWWWWWWWWWWWWWWWWWWWWWWWWWWWWWWWWWWWWWWWWWW"
"WWWWWWWWWWWWWWWWWWWWWWWWWWWWWWWWWWWWWWWWWWWWWWWWWWWWWWWWWWWWWWWWWWWWWWWWWWWWWWWWWWWWWWWWWW"
"WWWWWWWWWWWWW                                          WW                                E"
"WWWWWWWWWWWWW                                          WW                                E"
"WWWWWWWWWWWWW                                          WW                                E"
"WWWWWWWWWWWWW                                          WW                                E"
"WWWWWWWWWWWWW                                          WW                                E"
"WWWWWWWWWWWWW                                          WW                                E"
"WWWWWWWWWWWWW                                          WW                                E"
"WWWWWWWWWWWWW                                          WW                                E"
"WWWWWWWWWWWWW                                          WW                                E"
"WWWWWWWWWWWWW                                          WW                                E"
"WWWWWWWWWWWWW                     WW                   WW                        WWWWWWWWW"
"WWWWWWWWWWWWW                     WW                   WW                        WWWWWWWWW"
"WWWWWWWWWWWWW                     WW                   WW                        WWWWWWWWW"
"WWWWWWWWWWWWW                     WW                   WW                        WWWWWWWWW"
"WWWWWWWWWWWWW                     WW                   WW                        WWWWWWWWW"
"WWWWWWWWWWWWW                     WW                   WW                        WWWWWWWWW"
"WWWWWWWWWWWWW                     WW                   WW                        WWWWWWWWW"
"WWWWWWWWWWWWW                     WW                   WW                        WWWWWWWWW"
"WWWWWWWWWWWWW                     WW                   WW                        WWWWWWWWW"
"WWWWWWWWWWWWW                     WW                   WW                        WWWWWWWWW"
"WWWWWWWWWWWWW                     WW                   WW                        WWWWWWWWW"
"WWWWWWWWWWWWW                     WW                   WW                        WWWWWWWWW"
"WWWWWWWWWWWWW                     WW                   WW                        WWWWWWWWW"
"WWWWWWWWWWWWW                     WW                   WW                        WWWWWWWWW"
"WWWWWWWWWWWWW                     WW                   WW                        WWWWWWWWW"
"WWWWWWWWWWWWW                     WW                   WW                        WWWWWWWWW"
"WWWWWWWWWWWWW                     WW                   WW                        WWWWWWWWW"
"WWWWWWWWWWWWW                     WW                   WW                        WWWWWWWWW"
"WWWWWWWWWWWWW                     WW                   WW                        WWWWWWWWW"
"WWWWWWWWWWWWW                     WW                   WW                        WWWWWWWWW"
"WWWWWWWWWWWWW                     WW                   WW                        WWWWWWWWW"
"WWWWWWWWWWWWW                     WW                   WW                        WWWWWWWWW" 
"WWWWWWWWWWWWW                     WW                   WW                        WWWWWWWWW"
"WWWWWWWWWWWWW                     WW                   WW                        WWWWWWWWW"
"WWWWWWWWWWWWW                     WW                   WW                        WWWWWWWWW"
"WWWWWWWWWWWWW                     WW                   WW                        WWWWWWWWW"
"WWWWWWWWWWWWW                     WW                                             WWWWWWWWW"
"WWWWWWWWWWWWW                     WW                                             WWWWWWWWW"
"WWWWWWWWWWWWW                     WW                                             WWWWWWWWW"
"WWWWWWWWWWWWW                     WW                                             WWWWWWWWW"
"WWWWWWWWWWWWW                     WW                                             WWWWWWWWW"
"WWWWWWWWWWWWW                     WW                                             WWWWWWWWW"
"WWWWWWWWWWWWW       R             WW                                             WWWWWWWWW"
"WWWWWWWWWWWWW                     WW                                             WWWWWWWWW"
"WWWWWWWWWWWWW                     WW                                             WWWWWWWWW"
"WWWWWWWWWWWWW                     WW                                             WWWWWWWWW"
"WWWWWWWWWWWWW                     WW                                             WWWWWWWWW"
"WWWWWWWWWWWWW                     WW                                             WWWWWWWWW"
"WWWWWWWWWWWWWWWWWWWWWWWWWWWWWWWWWWWWWWWWWWWWWWWWWWWWWWWWWWWWWWWWWWWWWWWWWWWWWWWWWWWWWWWWWW"
"WWWWWWWWWWWWWWWWWWWWWWWWWWWWWWWWWWWWWWWWWWWWWWWWWWWWWWWWWWWWWWWWWWWWWWWWWWWWWWWWWWWWWWWWWW"
"WWWWWWWWWWWWWWWWWWWWWWWWWWWWWWWWWWWWWWWWWWWWWWWWWWWWWWWWWWWWWWWWWWWWWWWWWWWWWWWWWWWWWWWWWW"
"WWWWWWWWWWWWWWWWWWWWWWWWWWWWWWWWWWWWWWWWWWWWWWWWWWWWWWWWWWWWWWWWWWWWWWWWWWWWWWWWWWWWWWWWWW"
"WWWWWWWWWWWWWWWWWWWWWWWWWWWWWWWWWWWWWWWWWWWWWWWWWWWWWWWWWWWWWWWWWWWWWWWWWWWWWWWWWWWWWWWWWW"
"WWWWWWWWWWWWWWWWWWWWWWWWWWWWWWWWWWWWWWWWWWWWWWWWWWWWWWWWWWWWWWWWWWWWWWWWWWWWWWWWWWWWWWWWWW"