"WWWWWWWWWWWWWWWWWWWWWWWWWWWWWWWWWWWWWWWWWWWWWWWWWWWWWWWWWWWWWWWWWWWWWWWWWWWWWWWWWWWWWWWWWW",
"WWWWWWWWWWWWWWWWWWWWWWWWWWWWWWWWWWWWWWWWWWWWWWWWWWWWWWWWWWWWWWWWWWWWWWWWWWWWWWWWWWWWWWWWWW",
"WWWWWWWWWWWWWWWWWWWWWWWWWWWWWWWWWWWWWWWWWWWWWWWWWWWWWWWWWWWWWWWWWWWWWWWWWWWWWWWWWWWWWWWWWW",
"WWWWWWWWWWWWWWWWWWWWWWWWWWWWWWWWWWWWWWWWWWWWWWWWWWWWWWWWWWWWWWWWWWWWWWWWWWWWWWWWWWWWWWWWWW",
"WWWWWWWWWWWWWWWWWWWWWWWWWWWWWWWWWWWWWWWWWWWWWWWWWWWWWWWWWWWWWWWWWWWWWWWWWWWWWWWWWWWWWWWWWW",
"WWWWWWWWWWWWWWWWWWWWWWWWWWWWWWWWWWWWWWWWWWWWWWWWWWWWWWWWWWWWWWWWWWWWWWWWWWWWWWWWWWWWWWWWWW",
"WWWWWWWWWWWWWWWWWWWWWWWWWWWWWWWWWWWWWWWWWWWWWWWWWWWWWWWWWWWWWWWWWWWWWWWWWWWWWWWWWWWWWWWWWW",
"WWWWWWWWWWWWWWWWWWWWWW                                         WWWWWWWWWWWWWWWWWWWWWWWWWWW",
"WWWWWWWWWWWWWWWWWWWWWW                 T                       WWWWWWWWWWWWWW            E",
"WWWWWWWWWWWWWWWWWWWWWW                                         WWWWWWWWWWWWW             E",
"WWWWWWWWWWWWWWWWWWWWWW                                         WWWWWWWWWWWW              E",
"WWWWWWWWWWWWWWWWWWWWWW                                         WWWWWWWWWWW               E",
"WWWWWWWWWWWWWWWWWWWWWW                                         WWWWWWWWWW                E",
"WWWWWWWWWWWWWWWWWWWWWW                                         WWWWWWWWW                 E",
"WWWWWWWWWWWWWWWWWWWWWW                                         WWWWWWWW                  E",
"WWWWWWWWWWWWWWWWWWWWWW                                         WWWWWWWWWWW               E",
"WWWWWWWWWWWWWWWWWWWWWW                                         WWWWWWWWWWWWWW            E",
"WWWWWWWWWWWWWWWWWWWWWW              WWWWWWWWWWW                WWWWWWWWWWWWWW            W",
"WWWWWWWWWWWWWWWWWWWWWW              WWWWWWWWWWW                WWWWWWWWWWWWWW            W",
"WWWWWWWWWWWWWWWWWWWWWW              WWWWWWWWWWW                WWWWWWWWWWWWWW            W",
"WWWWWWWWWWWWWWWWWWWWWW              WWWWWWWWWWW                WWWWWWWWWWWWWW            W",
"WWWWWWWWWWWWWWWWWWWWWW              WWWWWWWWWWW                WWWWWWWWWWWWWW            W",
"WWWWWWWWWWWWWWWWWWWWWW              WWWWWWWWWWW                WWWWWWWWWWWWWW            W",
"WWWWWWWWWWWWWWWWWWWWWW              WWWWWWWWWWW                WWWWWWWWWWWWWW            W",
"WWWWWWWWWWWWWWWWWWWWWW              WWWWWWWWWWW                WWWWWWWWWWWWWW            W",
"WWWWWWWWWWWWWWWWWWWWWW              WWWWWWWWWWW                WWWWWWWWWWWWWW            W",
"WWWWWWWWWWWWWWWWWWWWWW              WWWWWWWWWWW                WWWWWWWWWWWWWW            W",
"WWWWWWWWWWWWWWWWWWWWWW              WWWWWWWWWWW                WWWWWWWWWWWWWW            W",
"WWWWWWWWWWWWWWWWWWWWWW              WWWWWWWWWWW                                          W",
"WWWWWWWWWWWWWWWWWWWWWW              WWWWWWWWWWW                                          W",
"WWWWWWWWWWWWWWWWWWWWWW              WWWWWWWWWWW                                          W",
"WWWWWWWWWWWWWWWWWWWWWW              WWWWWWWWWWW                                          W",
"WWWWWWWWWWWWWWWWWWWWWW              WWWWWWWWWWW                                          W",
"WWWWWWWWWWWWWWWWWWWWWW              WWWWWWWWWWW                                          W",
"WWWWWWWWWWWWWWWWWWWWWW              WWWWWWWWWWW                                          W",
"W                                   WWWWWWWWWWW                                          W",
"W                                   WWWWWWWWWWW                                          W",
"W                                   WWWWWWWWWWW                                          W",
"W                                   WWWWWWWWWWW                                          W",
"W                                   WWWWWWWWWWWWWWWWWWWWWWWWWWWWWWWWWWWWWWWWWWWWWWWWWWWWWW",
"W                                   WWWWWWWWWWWWWWWWWWWWWWWWWWWWWWWWWWWWWWWWWWWWWWWWWWWWWW",
"W                                   WWWWWWWWWWWWWWWWWWWWWWWWWWWWWWWWWWWWWWWWWWWWWWWWWWWWWW",
"W                                   WWWWWWWWWWWWWWWWWWWWWWWWWWWWWWWWWWWWWWWWWWWWWWWWWWWWWW",
"W         R                         WWWWWWWWWWWWWWWWWWWWWWWWWWWWWWWWWWWWWWWWWWWWWWWWWWWWWW",
"W                                  wWWWWWWWWWWWWWWWWWWWWWWWWWWWWWWWWWWWWWWWWWWWWWWWWWWWWWW",
"W                              WWWWWWWWWWWWWWWWWWWWWWWWWWWWWWWWWWWWWWWWWWWWWWWWWWWWWWWWWWW",
"W                              WWWWWWWWWWWWWWWWWWWWWWWWWWWWWWWWWWWWWWWWWWWWWWWWWWWWWWWWWWW",
"W                              WWWWWWWWWWWWWWWWWWWWWWWWWWWWWWWWWWWWWWWWWWWWWWWWWWWWWWWWWWW",
"W                              WWWWWWWWWWWWWWWWWWWWWWWWWWWWWWWWWWWWWWWWWWWWWWWWWWWWWWWWWWW",
"W                              WWWWWWWWWWWWWWWWWWWWWWWWWWWWWWWWWWWWWWWWWWWWWWWWWWWWWWWWWWW",
"W                              WWWWWWWWWWWWWWWWWWWWWWWWWWWWWWWWWWWWWWWWWWWWWWWWWWWWWWWWWWW",
"WWWWWWWWWWWWWWWWWWWWWWWWWWWWWWWWWWWWWWWWWWWWWWWWWWWWWWWWWWWWWWWWWWWWWWWWWWWWWWWWWWWWWWWWWW",
"WWWWWWWWWWWWWWWWWWWWWWWWWWWWWWWWWWWWWWWWWWWWWWWWWWWWWWWWWWWWWWWWWWWWWWWWWWWWWWWWWWWWWWWWWW",
"WWWWWWWWWWWWWWWWWWWWWWWWWWWWWWWWWWWWWWWWWWWWWWWWWWWWWWWWWWWWWWWWWWWWWWWWWWWWWWWWWWWWWWWWWW",
"WWWWWWWWWWWWWWWWWWWWWWWWWWWWWWWWWWWWWWWWWWWWWWWWWWWWWWWWWWWWWWWWWWWWWWWWWWWWWWWWWWWWWWWWWW",
"WWWWWWWWWWWWWWWWWWWWWWWWWWWWWWWWWWWWWWWWWWWWWWWWWWWWWWWWWWWWWWWWWWWWWWWWWWWWWWWWWWWWWWWWWW",
