"WWWWWWWWWWWWWWWWWWWWWWWWWWWWWWWWWWWWWWWWWWWWWWWWWWWWWWWWWWWWWWWWWWWWWWWWWWWWWWWWWWWWWWWWWW",
"WWWWWWWWWWWWWW               WWWWWWWWWW               WWWWWWWWWWW        WWWWW          WW",
"WWWWWWWWWWWWWW               WWWWWWWWWW               WWWWWWWWWWW        WWWWW          WW",
"WWWWWWWWWWWWWW               WWWWWWWWWW               WWWWWWWWWWW        WWWWW          WW",
"WWWWWWWWWWWWWW               WWWWWWWWWW               WWWWWWWWWWW        WWWWW          WW",
"WWWWWWWWWWWWWW               WWWWWWWWWW               WWWWWWWWWWW        WWWWW          WW",
"WWWWWWWWWWWWWW               WWWWWWWWWW               WWWWWWWWWWW        WWWWW          WW",
"WWWWWWWWWWWWWW               WWWWWWWWWW               WWWWWWWWWWW        WWWWW          WW",
"WWWWWWWWWWWWWW               WWWWWWWWWW               WWWWWWWWWWW        WWWWW          WW",
"WWWWWWWWWWWWWW               WWWWWWWWWW               WWWWWWWWWWW        WWWWW          WW",
"WWWWWWWWWWWWWW       T       WWWWWWWWWW               WWWWWWWWWWW        WWWWW          WW",
"WWWWWWWWWWWWWW               WWWWWWWWWW       T       WWWWWWWWWWW        WWWWW      T   WW",
"WWWWWWWWWWWWWW               WWWWWWWWWW               WWWWWWWWWWW        WWWWW          WW",
"WWWWWWWWWWWWWW               WWWWWWWWWW               WWWWWWWWWWW        WWWWW          WW",
"WWWW                                                                                    WW",
"WWWW                                                                                    WW",
"WWWW                                                                                    WW",
"WWWW                                                                                    WW",
"WWWW                                                                                    WW",
"WWWW                                                                                    WW",
"WWWW                                                                                    WW",
"WWWW                                                                                    WW",
"WWWW                                                                                    WW",
"WWWW                                                                                    WW",
"WWWW                                                                                    WW",
"WWWW                                                                                    WW",
"WWWW                                                                                    WW",
"WWWW                                                                                    WW",
"WWWW                                                                                    WW",
"WWWW                                                                                    WW",
"WWWW                                                                                    WW",
"WWWW                                                                                    WW",
"WWWW                                                                                    WW",
"WWWW                                                                                    WW",
"WWWW                                                                                    WW",
"WWWW                                                                                    WW",
"WWWW                                                                                    WW",
"WWWW                                                                                    WW",
"WWWW                                                                                    WW",
"WWWW                                                                                    WW",
"WWWW                                                                                    WW",
"WWWW                                                                                    WW",
"WWWW                                                                                    WW",
"WWWW                                                                                    WW",
"WWWW                                                                                    WW",
"WWWWWWWWWWWWWW               WWWWWWWWWW               WWWWWWWWWWW        WWWWW          WW",
"WWWWWWWWWWWWWW               WWWWWWWWWW               WWWWWWWWWWW        WWWWW          WW",
"WWWWWWWWWWWWWW               WWWWWWWWWW               WWWWWWWWWWW   T    WWWWW          WW",
"WWWWWWWWWWWWWW               WWWWWWWWWW       T       WWWWWWWWWWW        WWWWW          WW",
"WWWWWWWWWWWWWW               WWWWWWWWWW               WWWWWWWWWWW        WWWWW          WW",
"WWWWWWWWWWWWWW               WWWWWWWWWW               WWWWWWWWWWW        WWWWW          WW",
"WWWWWWWWWWWWWW               WWWWWWWWWW               WWWWWWWWWWW        WWWWW          WW",
"WWWWWWWWWWWWWW       R       WWWWWWWWWW               WWWWWWWWWWW        WWWWW          WW",
"WWWWWWWWWWWWWW               WWWWWWWWWW               WWWWWWWWWWW        WWWWW          WW",
"WWWWWWWWWWWWWW               WWWWWWWWWW               WWWWWWWWWWW        WWWWW          WW",
"WWWWWWWWWWWWWWWWWWWWWWWWWWWWWWWWWWWWWWWWWWWWWWWWWWWWWWWWWWWWWWWWWWWWWWWWWWWWWWEEEEEEEEEEWW",
