"WWWWWWWWWWWWWWWWWWWWWWWWWWWWWWWWWWWWWWWWWWWWWWWWWWWWWWWWWWWWWWWWWWWWWWWWWWWWWWWWWWWWWWWWW",
"WWWWWWWWWWWWWWWWWWWWWWWWWWWWWWWWWWWWWWWWWWWWWWWWWWWWWWWWWWWWWWWWWWWWWWWWWWWWWWWWWWWWWWWWW",
"WW                                                                                      W",
"WW                                                                                      W",
"WW                                                                         T            W",
"WW                                                                                      W",
"WW     R                                                                                W",
"WW                                                                                      W",
"WW                                                                                      W",
"WW                                                                                      W",
"WW                                                                                      W",
"WW                                                                                      W",
"WW                                                                                      W",
"WW                                                                                      W",
"WW                                                                                      W",
"WW                                                                                      W",
"WW                                                                                      W",
"WW                                                                                      W",
"WW                                                                                      W",
"WW                                                                                      W",
"WW                                                                                      W",
"WW                                                                                      W",
"WW                                                                                      W",
"WW                                                                                      W",
"WW                                                                                      E",
"WW                                                                                      E",
"WW                                                                                      E",
"WW                                                                                      E",
"WW                                                                                      E",
"WW                                                                                      E",
"WW                                                                                      E",
"WW                                                                                      E",
"WW                                                                                      W",
"WW                                                                                      W",
"WW                                                                                      W",
"WW                                                                                      W",
"WW                                                                                      W",
"WW                                                                                      W",
"WW                                                                                      W",
"WW                                                                                      W",
"WW                                                                                      W",
"WW                                                                                      W",
"WW                                                                                      W",
"WW                                                                                      W",
"WW                                                                                      W",
"WW                                                                        T             W",
"WW                                                                                      W",
"WW                                                                                      W",
"WW                                                                                      W",
"WW                                                                                      W",
"WW                T                                                                     W",
"WW                                                                                      W",
"WW                                                                                      W",
"WW                                                                                      W",
"WW                                                                                      W",
"WW                                                                                      W",
"WWWWWWWWWWWWWWWWWWWWWWWWWWWWWWWWWWWWWWWWWWWWWWWWWWWWWWWWWWWWWWWWWWWWWWWWWWWWWWWWWWWWWWWWW",
"WWWWWWWWWWWWWWWWWWWWWWWWWWWWWWWWWWWWWWWWWWWWWWWWWWWWWWWWWWWWWWWWWWWWWWWWWWWWWWWWWWWWWWWWW",
